____________________________________________________________________
__0  _______________________________________________________________
____ _______________________________________________________________
____ ______HHH__HHH__HHH__HHH__HHH__HHHH__HHHHH_HHHHHHH___       N__
____ ______   __   __    _    _                _       ___  ________
____ ______                                             __  ________
____ ______                                             H_  ________
____ ______                                             H_  ________
____4 HHHHH                  _      ___                 H_  ________
____          HHHHHHHHHHHHHHHHHHHHHHHHHHHHHHHHHHHHHHH       ________
____________________________________________________________________
